11111111111111
11000000000011
10000000001101
11100000001101
11100000010011
