1111111111111
101000100C001
1E1001P111101
1010000010101
100000000C001
1111111111111
